    EA ./textures/EA.xpm
WE ./textures/WE.xpm
NO ./textures/NO.xpm
SO ./textures/SO.xpm

C 135,206,235

F 116,102,59
11111111111111111111
10000000000000000001
10000000000000000001
10001010101010101001
10000000000000000001
10000000N00000001001
10000000000000001001
10000000000000001001
10000000000001111001
10000000000000000001
10000000000000000001
10000000000000000001
11111111111111111111