    EA ./textures/EA.xpm
WE ./textures/WE.xpm
NO ./textures/NO.xpm
SO ./textures/SO.xpm

C 135,206,210

F 116,102,59
11111111111111
11111000000011
10100N00000011
10010000000001
10000000000001
10000000000001
10000000000001
11111111111111